NNNNNNNNNNNNNN
NZ    N      N
NNNNN N NNNN N
N   N N NP N N
N N     NN   N
NNNNNNNNNNNNNN
